######################
#E      ##########I###
#### ##    ####      #
####M#####      #### #
####   ######I######F#
######################