######################
#E     ###    #####I##
####   M#I ##        #
#### ####I ##  ####I #
####       ########F #
######################