######################
#E   #############I###
####   M             #
#### #####      ###I #
####       I # #####F#
######################